+++++++++++++++
+..+....G.....+
+..+..........+
+..+..........+
+........++++++
+.............+
+.............+
+...+.+++.....+
+...+.+++.....+
+...+.+++.....+
+...+.........+
+...+.....+++++
+.....+++++...+
+...J.........+
+++++++++++++++